8	8	8	8	8	8	8	8	8	8	8	8	8	8	8	8	8	8	8	8
4	4	4	4	4	4	4	4	4	4	4	4	4	4	4	4	4	4	4	4
9   9   9   9   9   9   9   9   9   9   9   9   9   9   9   9   9   9   9   9
5	3	3	3	3	3	5	3	3	3	3	3	3	5	3	3	3	3	3	5
5	3	3	3	3	3	5	3	3	3	3	3	3	5	3	3	3	3	3	5
5	3	3	3	3	3	5	3	3	3	3	3	3	5	3	3	3	3	3	5
5	3	3	3	3	3	5	3	3	3	3	3	3	5	3	3	3	3	3	5
5	3	3	3	3	3	5	3	3	3	3	3	3	5	3	3	3	3	3	5
5	3	3	3	3	3	5	3	3	3	3	3	3	5	3	3	3	3	3	5
10	3	3	3	3	3	11	3	3	3	3	3	3	11	3	3	3	3	3	11
3	3	3	3	3	3	3	3	3	3	3	3	3	3	3	3	3	3	3	3
3	3	3	3	3	3	3	12	13	13	13	13	14	3	3	3	3	3	3	3
7	7	7	7	7	7	7	7	7	7	7	7	7	7	7	7	7	7	7	7
